{
  "timer": 125,
  "stars": [
    70, 55, 20
  ],
  "rows": 12,
  "columns": 10,
  "depth": 1,
  "tiles": [
     0,  0,  0,  0,  0,  0,  0,  0,  0,  0,
     0,  0, 11, 16,  1,  2, 10, 11,  0,  0,
     0,  7, 10,  6,  0,  0,  6,  7,  2,  0,
     0,  1, 10,  0,  0,  0,  0, 10, 16,  0,
     0, 16,  0,  4, 16,  0,  7,  0,  1,  0,
     0,  7,  0,  6,  0,  9,  2,  0, 10,  0,
     0, 16,  0,  0,  0,  0,  0,  0,  2,  0,
     0,  0,  2,  0,  1, 11,  0,  4,  0,  0,
     0,  4,  0,  7,  0,  0,  1,  0, 11,  0,
     0, 11,  0, 16,  6,  9,  9,  0,  7,  0,
     0,  1,  0, 11,  4,  9,  2,  0, 10,  0,
     0,  0,  0,  0,  0,  0,  0,  0,  0,  0
  ]
}