{
  "timer": 125,
  "stars": [
    70, 55, 20
  ],
  "rows": 12,
  "columns": 10,
  "depth": 1,
  "tiles": [
     0,  0,  0,  0,  0,  0,  0,  0,  0,  0,
     0, 13,  0, 15,  0, 17,  0,  2,  0,  0,
     0,  0,  2,  0, 14,  0, 13,  0, 15,  0,
     0, 14,  0,  7,  0, 13,  0,  1,  0,  0,
     0,  0, 11,  0, 17,  0,  7,  0, 11,  0,
     0,  7,  0,  2,  0, 17,  0, 15,  0,  0,
     0,  0, 13,  0,  7,  0, 13,  0,  1,  0,
     0, 17,  0, 11,  0,  1,  0, 17,  0,  0,
     0,  0, 15,  0, 13,  0, 11,  0,  2,  0,
     0, 14,  0,  7,  0, 17,  0,  7,  0,  0,
     0,  0, 17,  0,  1,  0, 14,  0, 17,  0,
     0,  0,  0,  0,  0,  0,  0,  0,  0,  0
  ]
}