{
  "timer": 90,
  "rows": 12,
  "columns": 10,
  "depth": 1,
  "tiles": [
    0,  0,  0,  0,  0,  0,  0,  0,  0, 0,
    0,  0,  0,  0,  0,  0,  0,  0,  0, 0,
    0,  0, 17, 14,  0,  0, 14, 16,  0, 0,
    0, 14,  0,  0, 16, 14,  0,  0, 17, 0,
    0, 15,  0,  0,  0,  0,  0,  0, 14, 0,
    0, 16,  0,  0, 15,  0,  0,  0, 15, 0,
    0, 14,  0,  0,  0, 17,  0,  0, 16, 0,
    0,  0, 15,  0,  0,  0,  0, 15,  0, 0,
    0,  0,  0, 17,  0,  0, 14,  0,  0, 0,
    0,  0,  0,  0, 15, 14,  0,  0,  0, 0,
    0,  0,  0,  0,  0,  0,  0,  0,  0, 0,
    0,  0,  0,  0,  0,  0,  0,  0,  0, 0
  ]
}