{
  "timer": 125,
  "stars": [
    70, 55, 20
  ],
  "rows": 12,
  "columns": 10,
  "depth": 1,
  "tiles": [
     0,  0,  0,  0,  0,  0,  0,  0,  0,  0,
     0,  0,  1,  8,  5, 17, 14,  6,  0,  0,
     0,  5, 17,  6,  8,  7,  0,  1,  7,  0,
     0,  6,  8,  5,  0,  0,  0,  0, 17,  0,
     0,  7, 17, 14,  0,  0,  6,  0,  0,  0,
     0, 13,  5,  6,  0, 13, 17,  1,  0,  0,
     0, 14,  0,  1,  0,  0, 13,  0,  0,  0,
     0,  1,  7,  0,  0,  0,  0,  0,  0,  0,
     0, 17, 14,  8,  1,  0,  0,  8, 17,  0,
     0,  0,  6,  5, 17,  5, 17,  8,  0,  0,
     0,  0,  0, 17,  7,  7, 13,  0,  0,  0,
     0,  0,  0,  0,  0,  0,  0,  0,  0,  0
  ]
}