{
  "timer": 125,
  "stars": [
    90, 75, 50
  ],
  "rows": 12,
  "columns": 10,
  "depth": 1,
  "tiles": [
     0,  0,  0,  0,  0,  0,  0,  0,  0,  0,
     0,  9,  0,  0, 15, 17,  0,  0, 16,  0,
     0,  0,  0,  7,  1, 14, 15,  0,  0,  0,
     0,  0,  0, 14,  0,  0, 12,  0,  0,  0,
     0,  0, 12,  9,  0,  0, 16,  7,  0,  0,
     0, 17, 13,  0, 17,  1,  0, 17,  1,  0,
     0, 15, 14,  0, 13, 16,  0, 13,  9,  0,
     0,  0,  1, 15,  0,  0,  1, 15,  0,  0,
     0,  0,  0,  0, 14,  9,  0,  0,  0,  0,
     0,  0,  0,  0,  7, 17,  0,  0,  0,  0,
     0, 16,  0, 17, 15,  1,  7,  0, 13,  0,
     0,  0,  0,  0,  0,  0,  0,  0,  0,  0
  ]
}