{
  "timer": 110,
  "stars": [
    60, 40, 20
  ],
  "rows": 12,
  "columns": 10,
  "depth": 1,
  "tiles": [
     0,  0,  0,  0,  0,  0,  0,  0,  0,  0,
     0,  0,  1, 16, 11, 14,  1, 16,  0,  0,
     0,  2,  0,  0,  0,  0,  0,  0,  2,  0,
    16,  0,  0, 15, 16, 11, 15,  0,  0, 16,
    14,  0,  2,  0,  0,  0,  0, 11,  0, 14,
     1,  0, 11,  0, 16,  1,  0, 16,  0, 15,
     1,  0,  2,  0,  1,  2,  0, 14,  0,  1,
    14,  0, 15,  0,  0,  0,  0, 15,  0,  2,
    16,  0,  0, 14, 15, 11,  2,  0,  0, 14,
     0, 11,  0,  0,  0,  0,  0,  0,  1,  0,
     0,  0, 16,  2, 14, 14, 16, 14,  0,  0,
     0,  0,  0,  0,  0,  0,  0,  0,  0,  0
  ]
}