{
  "timer": 110,
  "stars": [
    80, 60, 50
  ],
  "rows": 12,
  "columns": 10,
  "depth": 1,
  "tiles": [
     0,  0,  0,  0,  0,  0,  0,  0,  0,  0,
     0,  1,  2,  0, 12, 11,  7,  0,  0,  0,
     0, 12,  0,  1,  0,  0,  2,  0, 13,  0,
     0,  0, 13,  7,  0,  0, 13,  0,  7,  0,
     0,  0, 11,  0,  0,  0,  7,  0, 12,  0,
     0, 11, 13,  0,  1,  0,  2,  0,  0,  0,
     0,  2,  0,  0,  0,  0, 12,  0,  0,  0,
     0,  1, 11,  2, 12, 11,  1, 11, 12,  0,
     0,  0,  0,  0,  0,  0, 13,  0,  0,  0,
     0,  0, 12,  1,  0,  0,  7,  0, 11,  0,
     0,  7,  0,  2,  0,  0, 11, 12, 13,  0,
     0,  0,  0,  0,  0,  0,  0,  0,  0,  0
  ]
}