{
  "timer": 110,
  "stars": [
    70, 50, 20
  ],
  "rows": 12,
  "columns": 10,
  "depth": 1,
  "tiles": [
     0,  0,  0,  0,  0,  0,  0,  0,  0,  0,
     0,  0,  0,  0,  0, 13,  0,  0,  0,  0,
     0, 15, 15,  0, 12,  0,  0,  1,  7,  0,
     0,  1,  0,  0, 15, 12,  0,  0, 17,  0,
     0,  0,  0, 17,  0,  0,  7,  0,  0,  0,
    12,  0, 13,  0, 12, 13,  0, 17, 15,  0,
     0, 17,  1,  0, 17, 15,  0, 15,  0,  7,
     0,  0,  0,  7,  0,  0,  1,  0,  0,  0,
     0, 17,  0,  0, 12, 15,  0,  0,  1,  0,
     0,  7, 13,  0,  0, 12,  0,  7,  1,  0,
     0,  0,  0,  0, 15,  0,  0,  0,  0,  0,
     0,  0,  0,  0,  0,  0,  0,  0,  0,  0
  ]
}