{
  "timer": 125,
  "stars": [
    70, 55, 20
  ],
  "rows": 12,
  "columns": 10,
  "depth": 1,
  "tiles": [
     0,  0,  0,  0,  0,  0,  0,  0,  0,  0,
     0, 15,  0,  0, 15,  0, 13,  0,  3,  0,
     0, 12,  2,  0,  0, 11,  0, 15, 13,  0,
     0,  2, 15,  3, 11,  0,  7, 16, 16,  0,
     0,  7,  2, 13, 15, 16,  7,  7, 12,  0,
     0,  0,  3, 13,  2,  7, 12,  2,  0,  0,
     0,  0,  0, 16, 11, 16,  0,  0,  0,  0,
     0,  0,  2, 13, 12,  3, 11,  2,  0,  0,
     0, 11, 11,  2,  0,  0, 13, 12, 15,  0,
     0, 16, 12,  0,  3,  0,  0,  7,  3,  0,
     0,  0,  0,  0,  0,  0,  0,  0,  0,  0,
     0,  0,  0,  0,  0,  0,  0,  0,  0,  0
  ]
}