{
  "timer": 125,
  "stars": [
    70, 55, 20
  ],
  "rows": 12,
  "columns": 10,
  "depth": 1,
  "tiles": [
     0,  0,  0,  0,  0,  0,  0,  0,  0,  0,
     0,  0,  3,  0, 16, 15,  0, 14,  0,  0,
     0, 11,  0, 11,  0,  0,  9,  0, 16,  0,
     0,  0,  9,  0, 15,  9,  0, 14,  0,  0,
     0, 14,  0,  3, 11, 12, 11,  0,  3,  0,
     0, 15,  0, 12, 15, 16, 14,  0,  9,  0,
     0,  0, 13,  0, 16, 11,  0, 16,  0,  0,
     0, 16,  0, 13,  0,  0, 11,  0, 13,  0,
     0,  0, 14,  0, 15,  3,  0, 12,  0,  0,
     0, 13,  9, 12,  0,  0, 13, 15, 13,  0,
     0,  0,  3,  0,  9, 14,  0,  3,  0,  0,
     0,  0,  0,  0,  0,  0,  0,  0,  0,  0
  ]
}